width:
1440
height:
825
timer:
30

-----------------------------------------
Watch out, the ice is slippery!
....................
.......W....W.......
III.................
......III..III......
1..................X
iiii............iiii
....................
W.W.W..........W.W.W
IIIII..........IIIII
....................
W.W.W..........W.W.W
iiiiii........iiiiii
....................
...W.W........W.W...
...IIII......IIII...