width:
1440
height:
825
timer:
30

-----------------------------------------
Many, many, many, many, many rockets...
....................
R..W...........X....
...--..W.......--...
....W.--........W..R
...--..........--...
R..W......W....W....
...--....--....--...
....W...........W...
...--........W.--...
R..W........--.W....
...--..........--...
....W...........W..R
...--..........--...
.1..................
######..####..######....